Welcome
An Interactive Fiction
Release 1 / Serial number 240407 / Inform 7 build 6M62 (I6/v6.34 lib 6/12N) SD

Lab
You can see 23 Zm, a desk and a box (in which is 5 Zm) here.

I beg your pardon?

* * *

Welcome
An Interactive Fiction
Release 1 / Serial number 240407 / Inform 7 build 6M62 (I6/v6.34 lib 6/12N) SD

Lab
You can see 23 Zm, a desk and a box (in which is 5 Zm) here.

>actions
Actions listing on.

>bob, ball
[answering Bob that "ball"]
There is no reply.
[answering Bob that "ball" - succeeded]

* * *

>actions
Actions listing on.

>smell
[smelling Lab]
You smell nothing unexpected.
[smelling Lab - succeeded]

* * *

>actions
Actions listing on.

>stand up
[exiting]
[(1) getting off the table]
You get off the table.

Lab
You can see a table here.

[(1) getting off the table - succeeded]

[exiting - succeeded]

>actions
Actions listing on.

>actions off
Actions listing off.

>get on table
That's not something you can enter.

>stand on table
That's not something you can stand on.

* * *

Welcome
An Interactive Fiction
Release 1 / Serial number 240407 / Inform 7 build 6M62 (I6/v6.34 lib 6/12N) SD

Lab
You can see 23 Zm, a desk and a box (in which is 5 Zm) here.

>arthur, drop your ball
There is no reply.

>arthur, drop ball
Arthur puts down the ball.

* * *

Welcome
An Interactive Fiction
Release 1 / Serial number 240407 / Inform 7 build 6M62 (I6/v6.34 lib 6/12N) SD

Lab
You can see 23 Zm, a desk and a box (in which is 5 Zm) here.

>asdf
asdf//.

Untitled
An Interactive Fiction by Philip Riley
Release 1 / Serial number 230325 / Inform 7 build 6M62 (I6/v6.34 lib 6/12N) SD

Example Location

* * *

Welcome
An Interactive Fiction
Release 1 / Serial number 240407 / Inform 7 build 6M62 (I6/v6.34 lib 6/12N) SD

Lab
You can see 23 Zm, a desk and a box (in which is 5 Zm) here.

>asdf/
asdf//
Untitled
An Interactive Fiction by Philip Riley
Release 1 / Serial number 230325 / Inform 7 build 6M62 (I6/v6.34 lib 6/12N) SD

Example Location

* * *

Welcome
An Interactive Fiction
Release 1 / Serial number 240407 / Inform 7 build 6M62 (I6/v6.34 lib 6/12N) SD

Lab
You can see 23 Zm, a desk and a box (in which is 5 Zm) here.

>ball
frobble the ball

>asdf
That's not a verb I recognise.

* * *

Welcome
An Interactive Fiction
Release 1 / Serial number 240407 / Inform 7 build 6M62 (I6/v6.34 lib 6/12N) SD

Lab
You can see 23 Zm, a desk and a box (in which is 5 Zm) here.

>climb into ball
That's not something you can enter.

* * *

Welcome
An Interactive Fiction
Release 1 / Serial number 240407 / Inform 7 build 6M62 (I6/v6.34 lib 6/12N) SD

Lab
You can see 23 Zm, a desk and a box (in which is 5 Zm) here.

>discuss do your worst
I only understood you as far as wanting to discuss do your worst.

* * *

Welcome
An Interactive Fiction
Release 1 / Serial number 240407 / Inform 7 build 6M62 (I6/v6.34 lib 6/12N) SD

Lab
You can see 23 Zm, a desk and a box (in which is 5 Zm) here.

>discuss your do worst
That noun did not make sense in this context.

>discuss do your worst
I only understood you as far as wanting to discuss do your worst.

>discuss your
That noun did not make sense in this context.

>discuss worst
do your worst!

>do worst
do your worst!

>scope
1: yourself (579947)

* * *

Welcome
An Interactive Fiction
Release 1 / Serial number 240407 / Inform 7 build 6M62 (I6/v6.34 lib 6/12N) SD

Lab
You can see 23 Zm, a desk and a box (in which is 5 Zm) here.

>do your worst
do your worst!

>do worst
You can't reach into the room of quips.

>trace 5
[Parser tracing set to level 5.]

>do your worst
[ "do" do / "your" your / "worst" worst ]
   [NounDomain called at word 1 (domain1 (Compass object), domain2 nothing)
   seeking definite object
    Trying the north at word 1
Parse_name called
Pass 1: 0 Pass 2: 0 Pass 3: 0
    Trying the northeast at word 1
Parse_name called
Pass 1: 0 Pass 2: 0 Pass 3: 0
    Trying the northwest at word 1
Parse_name called
Pass 1: 0 Pass 2: 0 Pass 3: 0
    Trying the south at word 1
Parse_name called
Pass 1: 0 Pass 2: 0 Pass 3: 0
    Trying the southeast at word 1
Parse_name called
Pass 1: 0 Pass 2: 0 Pass 3: 0
    Trying the southwest at word 1
Parse_name called
Pass 1: 0 Pass 2: 0 Pass 3: 0
    Trying the east at word 1
Parse_name called
Pass 1: 0 Pass 2: 0 Pass 3: 0
    Trying the west at word 1
Parse_name called
Pass 1: 0 Pass 2: 0 Pass 3: 0
    Trying the up at word 1
Parse_name called
Pass 1: 0 Pass 2: 0 Pass 3: 0
    Trying the down at word 1
Parse_name called
Pass 1: 0 Pass 2: 0 Pass 3: 0
    Trying the inside at word 1
Parse_name called
Pass 1: 0 Pass 2: 0 Pass 3: 0
    Trying the outside at word 1
Parse_name called
Pass 1: 0 Pass 2: 0 Pass 3: 0
   [ND made 0 matches]
[Parsing for the verb 'no.verb' (1 lines)]

[line 0 * scope=Routine(221427) -> A_discussing]
 [line 0 token 1 word 1 : scope=Routine(221427)]
  [Scope routine called at stage 1]
  [Scope routine returned multiple-flag of 0]
  [Object list from word 1]
  [Calling NounDomain on location and actor]
   [NounDomain called at word 1 (domain1 Lab, domain2 yourself)
   seeking definite object
  [Scope routine called at stage 2]
    Trying do your worst at word 1
    Matched (1)
   [ND made 1 matches]
  [ND returned do your worst]
  [token resulted in success]
 [line 0 token 2 word 2 : END]
I only understood you as far as wanting to do something to do your worst.

>trace
[ "trace" trace ]
[Parsing for the verb 'trace' (4 lines)]

[line 0 * -> TraceOn]
 [line 0 token 1 word 2 : END]
[Line successfully parsed]
[Trace on.]

* * *

>do worst
You can't reach into the room of quips.

>worst
That noun did not make sense in this context.

* * *

>do worst
You can't reach into the room of quips.

>your
That noun did not make sense in this context.

>asdf
That noun did not make sense in this context.

>showme yourself
There seems to be no such object anywhere in the model world.

>showme
Lab - room
    yourself - person

>showme your
There seems to be no such object anywhere in the model world.

>showme me
yourself - person
location: in Lab
singular-named, proper-named; unlit, inedible, portable; male
list grouping key: none
printed name: "yourself"
printed plural name: "people"
indefinite article: none
description: "As good-looking as ever."
initial appearance: none
carrying capacity: 100

* * *

>do your worst
do your worst!

>your
do your worst!

* * *

Welcome
An Interactive Fiction
Release 1 / Serial number 240407 / Inform 7 build 6M62 (I6/v6.34 lib 6/12N) SD

Lab
You can see 23 Zm, a desk and a box (in which is 5 Zm) here.

>drive to main street
That's not a place you can drive to

>drive to the beach
beach
You are standing in the beach parking lot next to your car.

You drive to the beach

* * *

Welcome
An Interactive Fiction
Release 1 / Serial number 240407 / Inform 7 build 6M62 (I6/v6.34 lib 6/12N) SD

Lab
You can see 23 Zm, a desk and a box (in which is 5 Zm) here.

>drive to mall
You drive to the mall parking lot.

mall parking lot
You are standing in the mall parking lot next to your car.

>drive to the beach
You drive to the beach.

beach
You are standing in the beach parking lot next to your car.

* * *

Welcome
An Interactive Fiction
Release 1 / Serial number 240407 / Inform 7 build 6M62 (I6/v6.34 lib 6/12N) SD

Lab
You can see 23 Zm, a desk and a box (in which is 5 Zm) here.

>drive to the beach
foo

* * *

Welcome
An Interactive Fiction
Release 1 / Serial number 240407 / Inform 7 build 6M62 (I6/v6.34 lib 6/12N) SD

Lab
You can see 23 Zm, a desk and a box (in which is 5 Zm) here.

>drive to the mall
mall parking lot
You are standing in the mall parking lot next to your car.

You drive to the mall parking lot

* * *

Welcome
An Interactive Fiction
Release 1 / Serial number 240407 / Inform 7 build 6M62 (I6/v6.34 lib 6/12N) SD

Lab
You can see 23 Zm, a desk and a box (in which is 5 Zm) here.

>drop your ball
You can't see any such thing.

* * *

Welcome
An Interactive Fiction
Release 1 / Serial number 240407 / Inform 7 build 6M62 (I6/v6.34 lib 6/12N) SD

Lab
You can see 23 Zm, a desk and a box (in which is 5 Zm) here.

>east
Cave

>west
Outside Cave
There is a cave to the east.

>in
Cave

>out
Outside Cave
There is a cave to the east.

>enter cave
Cave

* * *

Welcome
An Interactive Fiction
Release 1 / Serial number 240407 / Inform 7 build 6M62 (I6/v6.34 lib 6/12N) SD

Lab
You can see 23 Zm, a desk and a box (in which is 5 Zm) here.

>enter ball
That's not something you can enter.

>climb into ball
You can't see any such thing.

* * *

Welcome
An Interactive Fiction
Release 1 / Serial number 240407 / Inform 7 build 6M62 (I6/v6.34 lib 6/12N) SD

Lab
You can see 23 Zm, a desk and a box (in which is 5 Zm) here.

>enter book store
book store
A book store.

>out
mall
A busy mall.

>s
electronics store
An electronics store.

>exit
mall
A busy mall.

* * *

Welcome
An Interactive Fiction
Release 1 / Serial number 240407 / Inform 7 build 6M62 (I6/v6.34 lib 6/12N) SD

Lab
You can see 23 Zm, a desk and a box (in which is 5 Zm) here.

>enter box
You get into the box.

The list holds 2 entrys. box

>out
You get out of the box.

Lab
This is the lab.

You can see a box (empty) here.

The list holds 2 entrys. Lab

* * *

Welcome
An Interactive Fiction
Release 1 / Serial number 240407 / Inform 7 build 6M62 (I6/v6.34 lib 6/12N) SD

Lab
You can see 23 Zm, a desk and a box (in which is 5 Zm) here.

>exit
You get off the table.

Lab
You can see a table here.

looked for the first time.

* * *

Welcome
An Interactive Fiction
Release 1 / Serial number 240407 / Inform 7 build 6M62 (I6/v6.34 lib 6/12N) SD

Lab
You can see 23 Zm, a desk and a box (in which is 5 Zm) here.

>fasdf
fasdf
Untitled
An Interactive Fiction by Philip Riley
Release 1 / Serial number 230325 / Inform 7 build 6M62 (I6/v6.34 lib 6/12N) SD

Example Location

* * *

Welcome
An Interactive Fiction
Release 1 / Serial number 240407 / Inform 7 build 6M62 (I6/v6.34 lib 6/12N) SD

Lab
You can see 23 Zm, a desk and a box (in which is 5 Zm) here.

>frotz
doesn't work

* * *

Welcome
An Interactive Fiction
Release 1 / Serial number 240407 / Inform 7 build 6M62 (I6/v6.34 lib 6/12N) SD

Lab
You can see 23 Zm, a desk and a box (in which is 5 Zm) here.

>get cerulean
You can't see any such thing.

* * *

Welcome
An Interactive Fiction
Release 1 / Serial number 240407 / Inform 7 build 6M62 (I6/v6.34 lib 6/12N) SD

Lab
You can see 23 Zm, a desk and a box (in which is 5 Zm) here.

>get off
You get off the table.

Lab
You can see a table here.

* * *

Welcome
An Interactive Fiction
Release 1 / Serial number 240407 / Inform 7 build 6M62 (I6/v6.34 lib 6/12N) SD

Lab
You can see 23 Zm, a desk and a box (in which is 5 Zm) here.

>give stone to me
You can't give the stone to yourself.

>give stone
(to yourself)
You can't give the stone to yourself.

* * *

Welcome
An Interactive Fiction
Release 1 / Serial number 240407 / Inform 7 build 6M62 (I6/v6.34 lib 6/12N) SD

Lab
You can see 23 Zm, a desk and a box (in which is 5 Zm) here.

>i
You are carrying:
  10 Zm

>drop 10 zm
None of those is available.

* * *

Welcome
An Interactive Fiction
Release 1 / Serial number 240407 / Inform 7 build 6M62 (I6/v6.34 lib 6/12N) SD

Lab
You can see 23 Zm, a desk and a box (in which is 5 Zm) here.

>in
You can't go that way.

>exit
Outside Cave
There is a cave to the east.

* * *

>in
You can't go that way.

>out
mall
A busy mall.

>w
book store
A book store.

>in
You can't go that way.

* * *

Welcome
An Interactive Fiction
Release 1 / Serial number 240407 / Inform 7 build 6M62 (I6/v6.34 lib 6/12N) SD

Lab
You can see 23 Zm, a desk and a box (in which is 5 Zm) here.

>incant ball with foo
bar

* * *

Welcome
An Interactive Fiction
Release 1 / Serial number 240407 / Inform 7 build 6M62 (I6/v6.34 lib 6/12N) SD

Lab
You can see 23 Zm, a desk and a box (in which is 5 Zm) here.

>insert
(the ball in the ball)
You can't put something inside itself.

>ball
What do you want to insert the ball in?

>box
(first taking the ball)
You put the ball into the box.

>take ball
Taken.

>insert
(the ball in the ball)
You can't put something inside itself.

>take box
Taken.

>insert
What do you want to insert?

>box
What do you want to insert the box in?

>box
You can't put something inside itself.

>insert
What do you want to insert?

>ball
What do you want to insert the ball in?

>box
You put the ball into the box.

>take ball
Taken.

>insert
What do you want to insert?

>drop box
Dropped.

>insert
(the ball in the ball)
You can't put something inside itself.

>take pyramid
Taken.

>insert
What do you want to insert?

>z
Time passes.

>drop ball
Dropped.

>insert
(the pyramid in the pyramid)
You can't put something inside itself.

>restart
Are you sure you want to restart?

>y
Welcome
An Interactive Fiction
Release 1 / Serial number 230407 / Inform 7 v10.1.2 / D

Lab
You can see a ball, a pyramid and a box (empty) here.

>insert
What do you want to insert?

>pyramid
What do you want to insert the pyramid in?

>box
(first taking the pyramid)
You put the pyramid into the box.

>undo
Lab
[Previous turn undone.]

>insert
What do you want to insert?

* * *

>pyramid
What do you want to insert the pyramid in?

>ball
(first taking the pyramid)
That can't contain things.

* * *

Welcome
An Interactive Fiction
Release 1 / Serial number 240407 / Inform 7 build 6M62 (I6/v6.34 lib 6/12N) SD

Lab
You can see 23 Zm, a desk and a box (in which is 5 Zm) here.

>jump
You jump on the spot.

WHEE!

>asdfasd
t: asdfasd.

* * *

>jump
You jump on the spot.

WHEE!

>jump
Turn count reset.

>jump
Turn count reset.

>z
Time passes.

>z
Time passes.

>jump
Turn count reset.

* * *

>jump
You jump on the spot.

WHEE!

>restart
Are you sure you want to restart?

>y
Welcome
An Interactive Fiction
Release 1 / Serial number 240401 / Inform 7 build 6M62 (I6/v6.34 lib 6/12N) SD

lab

>jump a lot
You jump on the spot.

WHEE!

You jump on the spot.

WHEE!

* * *

>jump
You jump on the spot.

WHEE!

>take ball
Taken.

>jump
Turn count reset.

>restart
Are you sure you want to restart?

>y
Welcome
An Interactive Fiction
Release 1 / Serial number 230424 / Inform 7 build 6M62 (I6/v6.34 lib 6/12N) SD

Lab
You can see a ball here.

>take ball
Taken.

>jump
Turn count reset.

foo

>jump
Turn count reset.

* * *

>jump
You jump on the spot.

WHEE!

>wave
The ball, the origami crane and the Declaration of Independence are mentioned in this sentence.

* * *

Welcome
An Interactive Fiction
Release 1 / Serial number 240407 / Inform 7 build 6M62 (I6/v6.34 lib 6/12N) SD

Lab
You can see 23 Zm, a desk and a box (in which is 5 Zm) here.

>l
Lab
You can see 23 Zm, a desk and a box (in which is 5 Zm) here.

>l
Lab
You can see 23 Zm, a desk and a box (in which is 5 Zm) here.

>take 4 zm
You are 4 Zm richer!

>l
Lab
You can see 19 Zm, a desk and a box (in which is 5 Zm) here.

>i
You are carrying:
  14 Zm

* * *

>l
Lab
You can see 23 Zm, a desk and a box (in which is 5 Zm) here.

>n
Garden

>restart
Are you sure you want to restart?

>y
Welcome
An Interactive Fiction
Release 1 / Serial number 230422 / Inform 7 v10.1.2 / D

Lab
looked for the first time.

>n
Garden
looked for the first time.

* * *

Welcome
An Interactive Fiction
Release 1 / Serial number 240407 / Inform 7 build 6M62 (I6/v6.34 lib 6/12N) SD

Lab
You can see 23 Zm, a desk and a box (in which is 5 Zm) here.

>mold clat
You can't see any such thing.

>mold clay
You may not name a second object.

* * *

>mold clay
I didn't understand that sentence.

>trace
[Trace on.]

>trace 5
[Parsing for the verb 'trace' (4 lines)]
[line 0 * -> TraceOn]
[line 1 * number -> TraceLevel]
[Line successfully parsed]
[Parser tracing set to level 5.]

>mold clay
[ "mold" mold / "clay" clay ]
[Parsing for the verb 'mold' (1 lines)]

[line 0 * noun 'into' Routine(221823) -> A_molding_it_into]
 [line 0 token 1 word 2 : noun]
  [Object list from word 2]
  [Calling NounDomain on location and actor]
   [NounDomain called at word 2 (domain1 Lab, domain2 yourself)
   seeking definite object
    Trying the north at word 2
Parse_name called
Pass 1: 0 Pass 2: 0 Pass 3: 0
    Trying the northeast at word 2
Parse_name called
Pass 1: 0 Pass 2: 0 Pass 3: 0
    Trying the northwest at word 2
Parse_name called
Pass 1: 0 Pass 2: 0 Pass 3: 0
    Trying the south at word 2
Parse_name called
Pass 1: 0 Pass 2: 0 Pass 3: 0
    Trying the southeast at word 2
Parse_name called
Pass 1: 0 Pass 2: 0 Pass 3: 0
    Trying the southwest at word 2
Parse_name called
Pass 1: 0 Pass 2: 0 Pass 3: 0
    Trying the east at word 2
Parse_name called
Pass 1: 0 Pass 2: 0 Pass 3: 0
    Trying the west at word 2
Parse_name called
Pass 1: 0 Pass 2: 0 Pass 3: 0
    Trying the up at word 2
Parse_name called
Pass 1: 0 Pass 2: 0 Pass 3: 0
    Trying the down at word 2
Parse_name called
Pass 1: 0 Pass 2: 0 Pass 3: 0
    Trying the inside at word 2
Parse_name called
Pass 1: 0 Pass 2: 0 Pass 3: 0
    Trying the outside at word 2
Parse_name called
Pass 1: 0 Pass 2: 0 Pass 3: 0
    Trying yourself at word 2
Parse_name called
Pass 1: 0 Pass 2: 0 Pass 3: 0
    Trying the clay at word 2
Parse_name called
Pass 1: 1 Pass 2: 1 Pass 3: 1
    Matched (1)
    Trying the box at word 2
Parse_name called
Pass 1: 0 Pass 2: 0 Pass 3: 0
   [ND made 1 matches]
  [ND returned the clay]
  [token resulted in success]
 [line 0 token 2 word 3 : 'into']
  [Preposition token]
  [token resulted in success]
 [line 0 token 3 word 3 : Routine(221823)]
  [Outside parsing routine returned -1]
  [token resulted in failure with error type 1]
I didn't understand that sentence.

>trace off
[ "trace" trace / "off" off ]
[Parsing for the verb 'trace' (4 lines)]

[line 0 * -> TraceOn]
 [line 0 token 1 word 2 : END]

[line 1 * number -> TraceLevel]
 [line 1 token 1 word 2 : number]
  [token resulted in failure with error type 3]

[line 2 * 'on' -> TraceOn]
[line rejected for not ending with correct preposition]

[line 3 * 'off' -> TraceOff]
 [line 3 token 1 word 2 : 'off']
  [Preposition token]
  [token resulted in success]
 [line 3 token 2 word 3 : END]
[Line successfully parsed]
Trace off.

>mold clay into
I didn't understand that sentence.

>mold clay
I didn't understand that sentence.

* * *

Welcome
An Interactive Fiction
Release 1 / Serial number 240407 / Inform 7 build 6M62 (I6/v6.34 lib 6/12N) SD

Lab
You can see 23 Zm, a desk and a box (in which is 5 Zm) here.

>n
whizbang!

Garden
This a nice garden.

>l
Garden
looked for the first time.

>s
Lab

>n
Garden

>n
You can't go that way.

* * *

>n
whizbang!

Garden
This a nice garden.

>s
Lab

>restart
Are you sure you want to restart?

>y
Welcome
An Interactive Fiction
Release 1 / Serial number 230422 / Inform 7 v10.1.2 / D

Lab (on the table)
looked for the first time.

>n
(first getting off the table)

Garden
looked for the first time.

>restart
Are you sure you want to restart?

>t
Please answer yes or no.

>y
Welcome
An Interactive Fiction
Release 1 / Serial number 230422 / Inform 7 v10.1.2 / D

Lab (on the table)
looked for the first time.

>get off
You get off the table.

Lab
You can see a table here.

looked for the first time.

>n
Garden

* * *

>n
whizbang!

Garden
This a nice garden.

>z
Time passes.

garden

>z
Time passes.

garden

>rules
Rules tracing now switched on. Type "rules off" to switch it off again, or "rules all" to include even rules which do not apply.

[Rule "parse command rule" applies.]

>n
[Rule "declare everything initially unmentioned rule" applies.]
[Rule "generate action rule" applies.]
[Rule "standard set going variables rule" applies.]
[Rule "announce items from multiple object lists rule" applies.]
[Rule "set pronouns from items from multiple object lists rule" applies.]
[Rule "before stage rule" applies.]
[Rule "basic visibility rule" applies.]
[Rule "basic accessibility rule" applies.]
[Rule "carrying requirements rule" applies.]
[Rule "instead stage rule" applies.]
[Rule "requested actions require persuasion rule" applies.]
[Rule "carry out requested actions rule" applies.]
[Rule "descend to specific action-processing rule" applies.]
[Rule "work out details of specific action rule" applies.]
[Rule "investigate player's awareness before action rule" applies.]
[Rule "player aware of his own actions rule" applies.]
[Rule "check stage rule" applies.]
[Rule "can't travel in what's not a vehicle rule" applies.]
[Rule "can't go through undescribed doors rule" applies.]
[Rule "can't go through closed doors rule" applies.]
[Rule "determine map connection rule" applies.]
[Rule "can't go that way rule" applies.]
You can't go that way.

[Rule "A first turn sequence rule" applies.]
[Rule "scene change machinery rule" applies.]
[Rule "every turn stage rule" applies.]
[Rule "Every turn when location is Garden for the first time" applies.]
garden
[Rule "timed events rule" applies.]
[Rule "advance time rule" applies.]
[Rule "update chronological records rule" applies.]
[Rule "A last turn sequence rule" applies.]
[Rule "scene change machinery rule" applies.]
[Rule "adjust light rule" applies.]
[Rule "note object acquisitions rule" applies.]
[Rule "notify score changes rule" applies.]
[Rule "parse command rule" applies.]

>z
[Rule "declare everything initially unmentioned rule" applies.]
[Rule "generate action rule" applies.]
[Rule "announce items from multiple object lists rule" applies.]
[Rule "set pronouns from items from multiple object lists rule" applies.]
[Rule "before stage rule" applies.]
[Rule "basic visibility rule" applies.]
[Rule "basic accessibility rule" applies.]
[Rule "carrying requirements rule" applies.]
[Rule "instead stage rule" applies.]
[Rule "requested actions require persuasion rule" applies.]
[Rule "carry out requested actions rule" applies.]
[Rule "descend to specific action-processing rule" applies.]
[Rule "work out details of specific action rule" applies.]
[Rule "investigate player's awareness before action rule" applies.]
[Rule "player aware of his own actions rule" applies.]
[Rule "check stage rule" applies.]
[Rule "carry out stage rule" applies.]
[Rule "after stage rule" applies.]
[Rule "investigate player's awareness after action rule" applies.]
[Rule "report stage rule" applies.]
[Rule "standard report waiting rule" applies.]
Time passes.
[Rule "last specific action-processing rule" applies.]

[Rule "A first turn sequence rule" applies.]
[Rule "scene change machinery rule" applies.]
[Rule "every turn stage rule" applies.]
[Rule "Every turn when location is Garden for the first time" applies.]
garden
[Rule "timed events rule" applies.]
[Rule "advance time rule" applies.]
[Rule "update chronological records rule" applies.]
[Rule "A last turn sequence rule" applies.]
[Rule "scene change machinery rule" applies.]
[Rule "adjust light rule" applies.]
[Rule "note object acquisitions rule" applies.]
[Rule "notify score changes rule" applies.]
[Rule "parse command rule" applies.]

* * *

>z
Time passes.

garden

>s
Lab

* * *

>n
Garden

>z
Time passes.

>n
You can't go that way.

>n
You can't go that way.

>s
Lab

* * *

>n
Garden

>s
Lab

* * *

>paint red with blue
You can't see any such thing.

* * *

Welcome
An Interactive Fiction
Release 1 / Serial number 240407 / Inform 7 build 6M62 (I6/v6.34 lib 6/12N) SD

Lab
You can see 23 Zm, a desk and a box (in which is 5 Zm) here.

>pray to Zeus
I dunno, try disguising yourself as a swan.

>pray to ASDF
You don't remember a prayer for that divinity.

* * *

>pray to Zeus
I dunno, try disguising yourself as a swan.

>pray to ball
That won't hear your prayers.

>pray to 5
That noun did not make sense in this context.

>pray to asdf
That noun did not make sense in this context.

>pray to pray
That noun did not make sense in this context.

>pray to player
That noun did not make sense in this context.

>showme
Lab - room
    yourself - person
    ball

>pray to yourself
That noun did not make sense in this context.

>pray to me
That won't hear your prayers.

* * *

Welcome
An Interactive Fiction
Release 1 / Serial number 240407 / Inform 7 build 6M62 (I6/v6.34 lib 6/12N) SD

Lab
You can see 23 Zm, a desk and a box (in which is 5 Zm) here.

>pray to asdf
I didn't understand that sentence.

* * *

Welcome
An Interactive Fiction
Release 1 / Serial number 240407 / Inform 7 build 6M62 (I6/v6.34 lib 6/12N) SD

Lab
You can see 23 Zm, a desk and a box (in which is 5 Zm) here.

>pray to ball
You may not name an object.

>pray to Zeus
I dunno, try disguising yourself as a swan.

* * *

Welcome
An Interactive Fiction
Release 1 / Serial number 240407 / Inform 7 build 6M62 (I6/v6.34 lib 6/12N) SD

Lab
You can see 23 Zm, a desk and a box (in which is 5 Zm) here.

>pray to vishnu
You don't remember a prayer for that divinity.

* * *

Welcome
An Interactive Fiction
Release 1 / Serial number 240407 / Inform 7 build 6M62 (I6/v6.34 lib 6/12N) SD

Lab
You can see 23 Zm, a desk and a box (in which is 5 Zm) here.

>pray to x
You don't remember a prayer for that divinity.

>pray to zeus
You don't remember a prayer for that divinity.

>pray to Zeus
You don't remember a prayer for that divinity.

* * *

Welcome
An Interactive Fiction
Release 1 / Serial number 240407 / Inform 7 build 6M62 (I6/v6.34 lib 6/12N) SD

Lab
You can see 23 Zm, a desk and a box (in which is 5 Zm) here.

>put ball in box
foo.

>i
You are carrying nothing.

* * *

>put ball in box
foo.

>x box
foo.

>take box
Taken.

* * *

Welcome
An Interactive Fiction
Release 1 / Serial number 240407 / Inform 7 build 6M62 (I6/v6.34 lib 6/12N) SD

Lab
You can see 23 Zm, a desk and a box (in which is 5 Zm) here.

>put cat in blue
You can't see any such thing.

>put cat in blue bix
You can't see any such thing.

>put cat in blue box
You can't see any such thing.

>x blue box
You can't see any such thing.

* * *

>put cat in blue
You can't see any such thing.

>put cat in blue box
(first taking the clay)
You put the clay into the box.

>take clay
Taken.

>put cat
(in the clay)
You can't put something inside itself.

>put cat into
(the clay)
You can't put something inside itself.

>put red
You can't see any such thing.

* * *

Welcome
An Interactive Fiction
Release 1 / Serial number 240407 / Inform 7 build 6M62 (I6/v6.34 lib 6/12N) SD

Lab
You can see 23 Zm, a desk and a box (in which is 5 Zm) here.

>quit
Are you absolutely certain you want to quit?

>y
Quitter!

    *** The End ***

Would you like to RESTART, RESTORE a saved game, QUIT or UNDO the last command?

>asdfasd
Please give one of the answers above.

* * *

Welcome
An Interactive Fiction
Release 1 / Serial number 240407 / Inform 7 build 6M62 (I6/v6.34 lib 6/12N) SD

Lab
You can see 23 Zm, a desk and a box (in which is 5 Zm) here.

>read E book 45
(shelf E book that)
What page?

>3
you choose to read nothing 3 3.

* * *

Welcome
An Interactive Fiction
Release 1 / Serial number 240407 / Inform 7 build 6M62 (I6/v6.34 lib 6/12N) SD

Lab
You can see 23 Zm, a desk and a box (in which is 5 Zm) here.

>read book
It looks interesting, but you would need to take the book to read it.

>take it
Taken.

>tread it
That's not a verb I recognise.

>read it
You read the book's pages:

Lorem ipsum dolor sit amet, consectetur adipiscing elit, sed do eiusmod tempor incididunt ut labore et dolore magna aliqua. Ut enim ad minim veniam, quis nostrud exercitation ullamco laboris nisi ut aliquip ex ea commodo consequat. Duis aute irure dolor in reprehenderit in voluptate velit esse cillum dolore eu fugiat nulla pariatur. Excepteur sint occaecat cupidatat non proident, sunt in culpa qui officia deserunt mollit anim id est laborum.

Lorem ipsum dolor sit amet, consectetur adipiscing elit, sed do eiusmod tempor incididunt ut labore et dolore magna aliqua. Ut enim ad minim veniam, quis nostrud exercitation ullamco laboris nisi ut aliquip ex ea commodo consequat. Duis aute irure dolor in reprehenderit in voluptate velit esse cillum dolore eu fugiat nulla pariatur. Excepteur sint occaecat cupidatat non proident, sunt in culpa qui officia deserunt mollit anim id est laborum.

You see nothing special about the notebook.

>read it
It looks interesting, but you would need to take the book to read it.

* * *

Welcome
An Interactive Fiction
Release 1 / Serial number 240407 / Inform 7 build 6M62 (I6/v6.34 lib 6/12N) SD

Lab
You can see 23 Zm, a desk and a box (in which is 5 Zm) here.

>read me book 4
Books are kept on bookshelves.

>show me shelf A
(first taking shelf A)
You see nothing special about shelf A.

>showme shelf A
shelf A - bookshelf
location: carried by yourself in Lab
singular-named, proper-named; unlit, inedible, portable, handled
list grouping key: none
printed name: "shelf A"
printed plural name: "bookshelves"
indefinite article: none
description: none
initial appearance: none

* * *

Welcome
An Interactive Fiction
Release 1 / Serial number 240407 / Inform 7 build 6M62 (I6/v6.34 lib 6/12N) SD

Lab
You can see 23 Zm, a desk and a box (in which is 5 Zm) here.

>read notebook'
You can't see any such thing.

>read notebook
It looks interesting, but you would need to take the book to read it.

>take it
Taken.

>read notebook
You read the book's pages:

Lorem ipsum dolor sit amet, consectetur adipiscing elit, sed do eiusmod tempor incididunt ut labore et dolore magna aliqua. Ut enim ad minim veniam, quis nostrud exercitation ullamco laboris nisi ut aliquip ex ea commodo consequat. Duis aute irure dolor in reprehenderit in voluptate velit esse cillum dolore eu fugiat nulla pariatur. Excepteur sint occaecat cupidatat non proident, sunt in culpa qui officia deserunt mollit anim id est laborum.

Lorem ipsum dolor sit amet, consectetur adipiscing elit, sed do eiusmod tempor incididunt ut labore et dolore magna aliqua. Ut enim ad minim veniam, quis nostrud exercitation ullamco laboris nisi ut aliquip ex ea commodo consequat. Duis aute irure dolor in reprehenderit in voluptate velit esse cillum dolore eu fugiat nulla pariatur. Excepteur sint occaecat cupidatat non proident, sunt in culpa qui officia deserunt mollit anim id est laborum.

You see nothing special about the notebook.

* * *

Welcome
An Interactive Fiction
Release 1 / Serial number 240407 / Inform 7 build 6M62 (I6/v6.34 lib 6/12N) SD

Lab
You can see 23 Zm, a desk and a box (in which is 5 Zm) here.

>read shelf A at 34
You can't see any such thing.

* * *

Welcome
An Interactive Fiction
Release 1 / Serial number 240407 / Inform 7 build 6M62 (I6/v6.34 lib 6/12N) SD

Lab
You can see 23 Zm, a desk and a box (in which is 5 Zm) here.

>read shelf A book 34
What page?

>6
you choose to read shelf A 34 6.

>read shelf A book 34
What page?

>l
Lab
You can see shelf A, shelf B, shelf C, shelf D and shelf E here.

>read shelf A book 3465
What page?

>3
you choose to read shelf A 3465 3.

>read me
As good-looking as ever.

* * *

Welcome
An Interactive Fiction
Release 1 / Serial number 240407 / Inform 7 build 6M62 (I6/v6.34 lib 6/12N) SD

Lab
You can see 23 Zm, a desk and a box (in which is 5 Zm) here.

>relations
glopping:
  3 >=> 4

* * *

Welcome
An Interactive Fiction
Release 1 / Serial number 240407 / Inform 7 build 6M62 (I6/v6.34 lib 6/12N) SD

Lab
You can see 23 Zm, a desk and a box (in which is 5 Zm) here.

>rules
Rules tracing now switched on. Type "rules off" to switch it off again, or "rules all" to include even rules which do not apply.

* * *

>actions
[Rule "declare everything initially unmentioned rule" applies.]
[Rule "generate action rule" applies.]
Actions listing on.

[Rule "parse command rule" applies.]

* * *

Welcome
An Interactive Fiction
Release 1 / Serial number 240407 / Inform 7 build 6M62 (I6/v6.34 lib 6/12N) SD

Lab
You can see 23 Zm, a desk and a box (in which is 5 Zm) here.

>s
Garden

>n
Lab

>rules
Rules tracing now switched on. Type "rules off" to switch it off again, or "rules all" to include even rules which do not apply.

[Rule "parse command rule" applies.]

* * *

>s
[Rule "declare everything initially unmentioned rule" applies.]
[Rule "generate action rule" applies.]
[Rule "standard set going variables rule" applies.]
[Rule "announce items from multiple object lists rule" applies.]
[Rule "set pronouns from items from multiple object lists rule" applies.]
[Rule "before stage rule" applies.]
[Rule "basic visibility rule" applies.]
[Rule "basic accessibility rule" applies.]
[Rule "carrying requirements rule" applies.]
[Rule "instead stage rule" applies.]
[Rule "requested actions require persuasion rule" applies.]
[Rule "carry out requested actions rule" applies.]
[Rule "descend to specific action-processing rule" applies.]
[Rule "work out details of specific action rule" applies.]
[Rule "investigate player's awareness before action rule" applies.]
[Rule "player aware of his own actions rule" applies.]
[Rule "check stage rule" applies.]
[Rule "can't travel in what's not a vehicle rule" applies.]
[Rule "can't go through undescribed doors rule" applies.]
[Rule "can't go through closed doors rule" applies.]
[Rule "determine map connection rule" applies.]
[Rule "can't go that way rule" applies.]
You can't go that way.

[Rule "A first turn sequence rule" applies.]
[Rule "scene change machinery rule" applies.]
[Rule "every turn stage rule" applies.]
[Rule "timed events rule" applies.]
[Rule "advance time rule" applies.]
[Rule "update chronological records rule" applies.]
[Rule "A last turn sequence rule" applies.]
[Rule "scene change machinery rule" applies.]
[Rule "adjust light rule" applies.]
[Rule "note object acquisitions rule" applies.]
[Rule "notify score changes rule" applies.]
[Rule "parse command rule" applies.]

* * *

Welcome
An Interactive Fiction
Release 1 / Serial number 240407 / Inform 7 build 6M62 (I6/v6.34 lib 6/12N) SD

Lab
You can see 23 Zm, a desk and a box (in which is 5 Zm) here.

>showme
Lab - room
    yourself - person
    ball

>showme ball
ball - thing
location: in Lab
singular-named, improper-named; unlit, inedible, portable
list grouping key: none
printed name: "ball"
printed plural name: none
indefinite article: none
description: none
initial appearance: "The ball is rolling about on the floor."

* * *

Welcome
An Interactive Fiction
Release 1 / Serial number 240407 / Inform 7 build 6M62 (I6/v6.34 lib 6/12N) SD

Lab
You can see 23 Zm, a desk and a box (in which is 5 Zm) here.

>showme door
Happy Door - two-sided door
location: in Lab
unlit, inedible, fixed in place; closed, openable, lockable, unlocked; singular-named, proper-named
description: none
initial appearance: none
leading-through destination: <routine 222269>
frontside: Lab
close delay: 0
time lock delay: 0
printed name: "Happy Door"
printed plural name: "two-sided doors"
indefinite article: none
list grouping key: none

* * *

Welcome
An Interactive Fiction
Release 1 / Serial number 240407 / Inform 7 build 6M62 (I6/v6.34 lib 6/12N) SD

Lab
You can see 23 Zm, a desk and a box (in which is 5 Zm) here.

>showme lab
Lab - room
    Happy Door - two-sided door
    yourself - person
lighted, visited; singular-named, proper-named
description: none
room condition: indoors
printed name: "Lab"
printed plural name: none
indefinite article: none
list grouping key: none

>showme door
Happy Door - two-sided door
location: in Lab
unlit, inedible, fixed in place; closed, openable, lockable, unlocked; front-openable, back-openable, front-closable, back-closable; singular-named, proper-named
description: none
initial appearance: none
leading-through destination: <routine 247040>
frontside: Lab
close delay: 0
time lock delay: 0
front description: none
back description: none
description policy: describe-always
lock countdown: -1
close countdown: -1
printed name: "Happy Door"
printed plural name: "two-sided doors"
indefinite article: none
list grouping key: none

>n
(first opening Happy Door)

Garden
Happy Door is open.

>s
Lab
Happy Door is open.

* * *

Welcome
An Interactive Fiction
Release 1 / Serial number 240407 / Inform 7 build 6M62 (I6/v6.34 lib 6/12N) SD

Lab
You can see 23 Zm, a desk and a box (in which is 5 Zm) here.

>smell
You smell onions.

>smell room
You can't see any such thing.

>smell lab
You can't see any such thing.

* * *

Welcome
An Interactive Fiction
Release 1 / Serial number 240407 / Inform 7 build 6M62 (I6/v6.34 lib 6/12N) SD

Lab
You can see 23 Zm, a desk and a box (in which is 5 Zm) here.

>smell ball
You smell nothing unexpected.

>smell
You smell nothing unexpected.

>actions
Actions listing on.

* * *

>i
You are carrying nothing.

>snatch all
ball: triangle:

I beg your pardon?

I beg your pardon?

* * *

Welcome
An Interactive Fiction
Release 1 / Serial number 240407 / Inform 7 build 6M62 (I6/v6.34 lib 6/12N) SD

Lab
You can see 23 Zm, a desk and a box (in which is 5 Zm) here.

>snatch balls
red ball: green ball:

I beg your pardon?

>snatch all balls
red ball: green ball:

I beg your pardon?

>get all balls
red ball: Taken.
green ball: Taken.

>drop all
green ball: Dropped.
red ball: Dropped.

* * *

Welcome
An Interactive Fiction
Release 1 / Serial number 240407 / Inform 7 build 6M62 (I6/v6.34 lib 6/12N) SD

Lab
You can see 23 Zm, a desk and a box (in which is 5 Zm) here.

>stand up
You get off the table.

Lab
You can see a table here.

looked for the first time.

>l
Lab
You can see a table here.

>get on table
You get onto the table.

>stand up
You get off the table.

Lab
You can see a table here.

>restart
Are you sure you want to restart?

* * *

>y
Welcome
An Interactive Fiction
Release 1 / Serial number 230422 / Inform 7 v10.1.2 / D

Lab (on the table)
looked for the first time.

>rules
Rules tracing now switched on. Type "rules off" to switch it off again, or "rules all" to include even rules which do not apply.

[Rule "parse command rule" applies.]

* * *

Welcome
An Interactive Fiction
Release 1 / Serial number 240407 / Inform 7 build 6M62 (I6/v6.34 lib 6/12N) SD

Lab
You can see 23 Zm, a desk and a box (in which is 5 Zm) here.

>status of computer
That's not a verb I recognise.

* * *

Welcome
An Interactive Fiction
Release 1 / Serial number 240407 / Inform 7 build 6M62 (I6/v6.34 lib 6/12N) SD

Lab
You can see 23 Zm, a desk and a box (in which is 5 Zm) here.

>stockpiles
Stockpiled: 
  explosives

* * *

Welcome
An Interactive Fiction
Release 1 / Serial number 240407 / Inform 7 build 6M62 (I6/v6.34 lib 6/12N) SD

Lab
You can see 23 Zm, a desk and a box (in which is 5 Zm) here.

>sysu
That noun did not make sense in this context.

* * *

Welcome
An Interactive Fiction
Release 1 / Serial number 240407 / Inform 7 build 6M62 (I6/v6.34 lib 6/12N) SD

Lab
You can see 23 Zm, a desk and a box (in which is 5 Zm) here.

>take all
ball: Taken.
origami crane: Taken.
Declaration of Independence: Taken.

>drop all
Declaration of Independence: You can't drop anything in this game.
origami crane: You can't drop anything in this game.
ball: You can't drop anything in this game.

>drop ball
You can't drop anything in this game.

* * *

Welcome
An Interactive Fiction
Release 1 / Serial number 240407 / Inform 7 build 6M62 (I6/v6.34 lib 6/12N) SD

Lab
You can see 23 Zm, a desk and a box (in which is 5 Zm) here.

>take apple
Taken.

>rules
Rules tracing now switched on. Type "rules off" to switch it off again, or "rules all" to include even rules which do not apply.

[Rule "parse command rule" applies.]

>drop apple
[Rule "declare everything initially unmentioned rule" applies.]
[Rule "generate action rule" applies.]
[Rule "announce items from multiple object lists rule" applies.]
[Rule "set pronouns from items from multiple object lists rule" applies.]
[Rule "before stage rule" applies.]
[Rule "basic visibility rule" applies.]
[Rule "basic accessibility rule" applies.]
[Rule "access through barriers rule" applies.]
[Rule "carrying requirements rule" applies.]
[Rule "instead stage rule" applies.]
[Rule "requested actions require persuasion rule" applies.]
[Rule "carry out requested actions rule" applies.]
[Rule "descend to specific action-processing rule" applies.]
[Rule "work out details of specific action rule" applies.]
[Rule "investigate player's awareness before action rule" applies.]
[Rule "player aware of his own actions rule" applies.]
[Rule "check stage rule" applies.]
[Rule "can't drop yourself rule" applies.]
[Rule "can't drop what's already dropped rule" applies.]
[Rule "can't drop what's not held rule" applies.]
[Rule "can't drop clothes being worn rule" applies.]
[Rule "can't drop if this exceeds carrying capacity rule" applies.]
[Rule "carry out stage rule" applies.]
[Rule "standard dropping rule" applies.]
[Rule "after stage rule" applies.]
[Rule "investigate player's awareness after action rule" applies.]
[Rule "report stage rule" applies.]
[Rule "standard report dropping rule" applies.]
Dropped.
[Rule "last specific action-processing rule" applies.]

[Rule "A first turn sequence rule" applies.]
[Rule "scene change machinery rule" applies.]
[Rule "every turn stage rule" applies.]
[Rule "timed events rule" applies.]
[Rule "advance time rule" applies.]
[Rule "update chronological records rule" applies.]
[Rule "A last turn sequence rule" applies.]
[Rule "scene change machinery rule" applies.]
[Rule "adjust light rule" applies.]
[Rule "note object acquisitions rule" applies.]
[Rule "notify score changes rule" applies.]
[Rule "parse command rule" applies.]

* * *

Welcome
An Interactive Fiction
Release 1 / Serial number 240407 / Inform 7 build 6M62 (I6/v6.34 lib 6/12N) SD

Lab
You can see 23 Zm, a desk and a box (in which is 5 Zm) here.

>take ball
Taken.

>i
foo.

* * *

>jump
Turn count reset.

foo

>jump
Turn count reset.

foo

>take ball
You already have that.

>jump
Turn count reset.

foo

>z
Time passes.

>jump
Turn count reset.

foo

* * *

>take ball
Taken.

>put it in box
You put the ball into the box.

* * *

>take ball
Taken.

>x it
You see nothing special about the ball.

we once took the ball

* * *

Welcome
An Interactive Fiction
Release 1 / Serial number 240407 / Inform 7 build 6M62 (I6/v6.34 lib 6/12N) SD

Lab
You can see 23 Zm, a desk and a box (in which is 5 Zm) here.

>take book
Taken.

>read it
You read page 1:

Lorem ipsum dolor sit amet, consectetur adipiscing elit, sed do eiusmod tempor incididunt ut labore et dolore magna aliqua. Ut enim ad minim veniam, quis nostrud exercitation ullamco laboris nisi ut aliquip ex ea commodo consequat. Duis aute irure dolor in reprehenderit in voluptate velit esse cillum dolore eu fugiat nulla pariatur. Excepteur sint occaecat cupidatat non proident, sunt in culpa qui officia deserunt mollit anim id est laborum.

Lorem ipsum dolor sit amet, consectetur adipiscing elit, sed do eiusmod tempor incididunt ut labore et dolore magna aliqua. Ut enim ad minim veniam, quis nostrud exercitation ullamco laboris nisi ut aliquip ex ea commodo consequat. Duis aute irure dolor in reprehenderit in voluptate velit esse cillum dolore eu fugiat nulla pariatur. Excepteur sint occaecat cupidatat non proident, sunt in culpa qui officia deserunt mollit anim id est laborum.

>read it
You read page 2:

Owner: We're closin" for lunch.

Mr. Praline: Never mind that, my lad. I wish to complain about this parrot what I purchased not half an hour ago from this very boutique.

You put the notebook on the desk.

>i
You are carrying nothing.

* * *

Welcome
An Interactive Fiction
Release 1 / Serial number 240407 / Inform 7 build 6M62 (I6/v6.34 lib 6/12N) SD

Lab
You can see 23 Zm, a desk and a box (in which is 5 Zm) here.

>take cat
Taken.

>put red cat in box
You put the clay into the box.

* * *

Welcome
An Interactive Fiction
Release 1 / Serial number 240407 / Inform 7 build 6M62 (I6/v6.34 lib 6/12N) SD

Lab
You can see 23 Zm, a desk and a box (in which is 5 Zm) here.

>take cerulean
You can't see any such thing.

>i
You are carrying nothing.

>scope
1: yourself (583955)

>showme cerulean
cerulean gel - reagent
location: out of play
singular-named, improper-named; unlit, inedible, portable
list grouping key: none
printed name: "gel"
printed plural name: "reagents"
indefinite article: none
description: none
initial appearance: none
secondary-element: magenta
comp-color: "cerulean"
element: cyan

>showme cerulean gel
cerulean gel - reagent
location: out of play
singular-named, improper-named; unlit, inedible, portable
list grouping key: none
printed name: "gel"
printed plural name: "reagents"
indefinite article: none
description: none
initial appearance: none
secondary-element: magenta
comp-color: "cerulean"
element: cyan

* * *

Welcome
An Interactive Fiction
Release 1 / Serial number 240407 / Inform 7 build 6M62 (I6/v6.34 lib 6/12N) SD

Lab
You can see 23 Zm, a desk and a box (in which is 5 Zm) here.

>take couch
Taken.

I beg your pardon?

* * *

>take couch
Taken.

>drop it
Dropped.

>take box
Taken.

>put it on the couch
You put the heavy box on the couch.

>take couch
The couch is too heavy with that box on it.

>move couch
Nothing obvious happens.

* * *

Welcome
An Interactive Fiction
Release 1 / Serial number 240407 / Inform 7 build 6M62 (I6/v6.34 lib 6/12N) SD

Lab
You can see 23 Zm, a desk and a box (in which is 5 Zm) here.

>take pistol
Taken. It ain't too accurate, but for two dollars you can't expect much.

* * *

Welcome
An Interactive Fiction
Release 1 / Serial number 240407 / Inform 7 build 6M62 (I6/v6.34 lib 6/12N) SD

Lab
You can see 23 Zm, a desk and a box (in which is 5 Zm) here.

>take red cat
Taken.

>i
You are carrying:
  a clay

>undo
Lab
[Previous turn undone.]

>take red
You can't see any such thing.

>take cat
You already have that.

>deop cat
That's not a verb I recognise.

>drop cat
Dropped.

>take red
You can't see any such thing.

>take cat
Taken.

* * *

Welcome
An Interactive Fiction
Release 1 / Serial number 240407 / Inform 7 build 6M62 (I6/v6.34 lib 6/12N) SD

Lab
You can see 23 Zm, a desk and a box (in which is 5 Zm) here.

>take sock
after taking rule.

after taking something rule.

Taken.

* * *

Welcome
An Interactive Fiction
Release 1 / Serial number 240407 / Inform 7 build 6M62 (I6/v6.34 lib 6/12N) SD

Lab
You can see 23 Zm, a desk and a box (in which is 5 Zm) here.

>take spinner
I don't suppose the sign spinner would care for that.

>take sketch
Taken.

>x it
You see nothing special about Zheng Yi Sao's Sketch.

we once took Zheng Yi Sao's Sketch

* * *

Welcome
An Interactive Fiction
Release 1 / Serial number 240407 / Inform 7 build 6M62 (I6/v6.34 lib 6/12N) SD

Lab
You can see 23 Zm, a desk and a box (in which is 5 Zm) here.

>take triangle
Taken.

>take circle
Taken.

>take square
Taken.

* * *

>take triangle
Taken.

>take square
Taken.

>take circle
Your hands are full!

Taken.

* * *

Welcome
An Interactive Fiction
Release 1 / Serial number 240407 / Inform 7 build 6M62 (I6/v6.34 lib 6/12N) SD

Lab
You can see 23 Zm, a desk and a box (in which is 5 Zm) here.

>test me
(Testing.)

>[1] i
You are carrying:
  10 Zm

>[2] x box
In the box is 5 Zm.

>[3] take 4 zorkmids
You are 4 Zm richer!

>[4] l
Lab
You can see 19 Zm, a desk and a box (in which is 5 Zm) here.

>[5] i
You are carrying:
  14 Zm

>read shelf rty book 4
Which do you mean, shelf A, shelf B, shelf C, shelf D or shelf E?

>trace 5
[Parser tracing set to level 5.]

* * *

>test me
(Testing.)

>[1] i
You are carrying:
  10 Zm

>[2] x box
In the box is 5 Zm.

>[3] take 4 zorkmids
You are 4 Zm richer!

>[4] l
Lab
You can see 19 Zm, a desk and a box (in which is 5 Zm) here.

>[5] i
You are carrying:
  14 Zm

>scope
1: yourself (586131)
2: a cerulean gel (586195)

* * *

>test me
(Testing.)

>[1] i
You are carrying:
  10 Zm

>[2] x box
In the box is 5 Zm.

>[3] take 4 zorkmids
You are 4 Zm richer!

>[4] l
Lab
You can see 19 Zm, a desk and a box (in which is 5 Zm) here.

>[5] i
You are carrying:
  14 Zm

>take 0 zm
You can't take no money at all.

You are 0 Zm richer!

* * *

>test me
(Testing.)

>[1] i
You are carrying:
  10 Zm

>[2] x box
In the box is 5 Zm.

>[3] take 4 zorkmids
You are 4 Zm richer!

>[4] l
Lab
You can see 19 Zm, a desk and a box (in which is 5 Zm) here.

>[5] i
You are carrying:
  14 Zm

>x it
You see nothing special about the cerulean gel.

* * *

Welcome
An Interactive Fiction
Release 1 / Serial number 240407 / Inform 7 build 6M62 (I6/v6.34 lib 6/12N) SD

Lab
You can see 23 Zm, a desk and a box (in which is 5 Zm) here.

>tinker pot
You carefully tinker the pot, studying and memorizing each step.

>tinker kettle
You tinker the kettle.

>tinker kettle
You tinker the kettle.

>tinker pan
You have yet to learn how to tinker a pan.

>tinker pot
You tinker the pot.

>tinker pan
You have yet to learn how to tinker a pan.

* * *

Welcome
An Interactive Fiction
Release 1 / Serial number 240407 / Inform 7 build 6M62 (I6/v6.34 lib 6/12N) SD

Lab
You can see 23 Zm, a desk and a box (in which is 5 Zm) here.

>trace 3
[Parser tracing set to level 3.]

>smell
[ "smell" smell ]
[Parsing for the verb 'smell' (3 lines)]

[line 0 * -> Smell]
 [line 0 token 1 word 2 : END]
[Line successfully parsed]
You smell nothing unexpected.

* * *

Welcome
An Interactive Fiction
Release 1 / Serial number 240407 / Inform 7 build 6M62 (I6/v6.34 lib 6/12N) SD

Lab
You can see 23 Zm, a desk and a box (in which is 5 Zm) here.

>turn on device
You switch the strange device on.

[Your score has just gone up by one point.]

* * *

Welcome
An Interactive Fiction
Release 1 / Serial number 240407 / Inform 7 build 6M62 (I6/v6.34 lib 6/12N) SD

Lab
You can see 23 Zm, a desk and a box (in which is 5 Zm) here.

>wave
The ball, the origami crane and the declaration of independence are mentioned in this sentence.

* * *

Welcome
An Interactive Fiction
Release 1 / Serial number 240407 / Inform 7 build 6M62 (I6/v6.34 lib 6/12N) SD

Lab
You can see 23 Zm, a desk and a box (in which is 5 Zm) here.

>who
(is Alice)
Alice is Alice.

>alice
you have frotzed Alice.

>who is
(Alice)
Alice is Alice.

>who owns
What do you want to who owns?

>who
What do you want to who owns?

>who alice
I didn't understand that sentence.

* * *

>who
(is Alice)
Alice is Alice.

>trace 6
[Parser tracing set to level 6.]

* * *

Welcome
An Interactive Fiction
Release 1 / Serial number 240407 / Inform 7 build 6M62 (I6/v6.34 lib 6/12N) SD

Lab
You can see 23 Zm, a desk and a box (in which is 5 Zm) here.

>who is me
yourself is yourself.

>who owns who
no one owns Who.

>who
What do you want to who owns?

>box
no one owns the box.

>box
you have frotzed the box

>trace 5
[Parser tracing set to level 5.]

>who
[ "who" who ]
[Parsing for the verb 'who' (2 lines)]

[line 0 * 'owns' noun -> A77_attributing]
 [line 0 token 1 word 2 : 'owns']
  [token resulted in success]
 [line 0 token 2 word 2 : noun]
  [Object list from word 2]
  [Calling NounDomain on location and actor]
   [NounDomain called at word 2
   seeking definite object
    Trying the north (579275) at word 2
    Matched (0)
    Trying the northeast (579307) at word 2
    Matched (0)
    Trying the northwest (579339) at word 2
    Matched (0)
    Trying the south (579371) at word 2
    Matched (0)
    Trying the southeast (579403) at word 2
    Matched (0)
    Trying the southwest (579435) at word 2
    Matched (0)
    Trying the east (579467) at word 2
    Matched (0)
    Trying the west (579499) at word 2
    Matched (0)
    Trying the up (579531) at word 2
    Matched (0)
    Trying the down (579563) at word 2
    Matched (0)
    Trying the inside (579595) at word 2
    Matched (0)
    Trying the outside (579627) at word 2
    Matched (0)
    Trying yourself (579659) at word 2
    Matched (0)
    Trying the box (579723) at word 2
    Matched (0)
    Trying Who (579755) at word 2
    Matched (0)
   [ND made 15 matches]
   [Adjudicating match list of size 15 in context 0
   definite object
   Scoring match list: indef mode 0 type 0, satisfying 0 requirements:

     The north (579275) in the compass : 2106 points

     The northeast (579307) in the compass : 2106 points

     The northwest (579339) in the compass : 2106 points

     The south (579371) in the compass : 2106 points

     The southeast (579403) in the compass : 2106 points

     The southwest (579435) in the compass : 2106 points

     The east (579467) in the compass : 2106 points

     The west (579499) in the compass : 2106 points

     The up (579531) in the compass : 2106 points

     The down (579563) in the compass : 2106 points

     The inside (579595) in the compass : 2106 points

     The outside (579627) in the compass : 2106 points

     You (579659) in Lab : 2051 points

     The box (579723) in Lab : 2156 points

     Who (579755) in Lab : 2156 points
   Grouped into 15 possibilities by name:
   The north (579275)  ---  group 1
   The northeast (579307)  ---  group 2
   The northwest (579339)  ---  group 3
   The south (579371)  ---  group 4
   The southeast (579403)  ---  group 5
   The southwest (579435)  ---  group 6
   The east (579467)  ---  group 7
   The west (579499)  ---  group 8
   The up (579531)  ---  group 9
   The down (579563)  ---  group 10
   The inside (579595)  ---  group 11
   The outside (579627)  ---  group 12
   You (579659)  ---  group 13
   The box (579723)  ---  group 14
   Who (579755)  ---  group 15
   Unable to choose best group, so ask player.]
What do you want to who owns?

* * *

Welcome
An Interactive Fiction
Release 1 / Serial number 240407 / Inform 7 build 6M62 (I6/v6.34 lib 6/12N) SD

Lab
You can see 23 Zm, a desk and a box (in which is 5 Zm) here.

>x box
In the box is 5 Zm.

>search box
The box is empty.

>rules
Rules tracing now switched on. Type "rules off" to switch it off again, or "rules all" to include even rules which do not apply.

>x box
[Rule "declare everything initially unmentioned rule" applies.]
[Rule "announce items from multiple object lists rule" applies.]
[Rule "set pronouns from items from multiple object lists rule" applies.]
[Rule "before stage rule" applies.]
[Rule "Before examining" applies.]
[Rule "can't act in the dark rule" applies.]
[Rule "instead stage rule" applies.]
[Rule "investigate player's awareness before action rule" applies.]
[Rule "player aware of his own actions rule" applies.]
[Rule "check stage rule" applies.]
[Rule "carry out stage rule" applies.]
[Rule "standard examining rule" applies.]
[Rule "examine directions rule" applies.]
[Rule "examine containers rule" applies.]
The box is empty.

[Rule "examine supporters rule" applies.]
[Rule "examine devices rule" applies.]
[Rule "examine undescribed things rule" applies.]
[Rule "after stage rule" applies.]
[Rule "After examining" applies.]
[Rule "investigate player's awareness after action rule" applies.]
[Rule "report stage rule" applies.]
[Rule "report other people examining rule" applies.]
[Rule "last specific action-processing rule" applies.]
[Rule "A first turn sequence rule" applies.]
[Rule "every turn stage rule" applies.]
[Rule "A last turn sequence rule" applies.]
[Rule "notify score changes rule" applies.]

* * *

>x box
In the box is 5 Zm.

>search the box
The box is empty.

>x desk
You see nothing special about the desk.

* * *

Welcome
An Interactive Fiction
Release 1 / Serial number 240407 / Inform 7 build 6M62 (I6/v6.34 lib 6/12N) SD

Lab
You can see 23 Zm, a desk and a box (in which is 5 Zm) here.

>x cerulean
You can't see any such thing.

* * *

Welcome
An Interactive Fiction
Release 1 / Serial number 240407 / Inform 7 build 6M62 (I6/v6.34 lib 6/12N) SD

Lab
You can see 23 Zm, a desk and a box (in which is 5 Zm) here.

>x door
You can't see any such thing.

>open door
You can't see any such thing.

>open happydoor
You open HappyDoor.

>n
HappyDoor is open.

>s
HappyDoor is open.

>n
HappyDoor is open.

>showme happydoor
HappyDoor - two-sided door
location: in 
unlit, inedible, fixed in place; open, openable, lockable, unlocked; front-openable, back-openable, front-closable, back-closable; singular-named, proper-named
description: none
initial appearance: none
initial mood: sad
sad description: none
sad name: none
leading-through destination: <routine 239649>
frontside: 
close delay: 0
time lock delay: 0
front description: none
back description: none
description policy: describe-always
lock countdown: -1
close countdown: -1
printed name: "HappyDoor"
printed plural name: "two-sided doors"
indefinite article: none
list grouping key: none

>showme lab
 - room
lighted, visited; singular-named, proper-named
description: none
current mood: sad
initial mood: sad
sad description: none
sad name: none
room condition: indoors
printed name: "Lab"
printed plural name: none
indefinite article: none
list grouping key: none

* * *

Welcome
An Interactive Fiction
Release 1 / Serial number 240407 / Inform 7 build 6M62 (I6/v6.34 lib 6/12N) SD

Lab
You can see 23 Zm, a desk and a box (in which is 5 Zm) here.

>x foo
You can't see any such thing.

>x ball
You see nothing special about the ball.

>take it
foo.

* * *

Welcome
An Interactive Fiction
Release 1 / Serial number 240407 / Inform 7 build 6M62 (I6/v6.34 lib 6/12N) SD

Lab
You can see 23 Zm, a desk and a box (in which is 5 Zm) here.

>x gel
You see nothing special about the cerulean gel.

>x cerulean
You can't see any such thing.

* * *

Welcome
An Interactive Fiction
Release 1 / Serial number 240407 / Inform 7 build 6M62 (I6/v6.34 lib 6/12N) SD

Lab
You can see 23 Zm, a desk and a box (in which is 5 Zm) here.

>x me
As good-looking as ever.

>jump
a.
b.

* * *

>x me
As good-looking as ever.

>take triangle
Taken.

>x left hand
The left hand is empty.

* * *

Welcome
An Interactive Fiction
Release 1 / Serial number 240407 / Inform 7 build 6M62 (I6/v6.34 lib 6/12N) SD

Lab
You can see 23 Zm, a desk and a box (in which is 5 Zm) here.

>x pawn shop
Which do you mean, Dave's pawn shop or the pawn shop door?

* * *

Welcome
An Interactive Fiction
Release 1 / Serial number 240407 / Inform 7 build 6M62 (I6/v6.34 lib 6/12N) SD

Lab
You can see 23 Zm, a desk and a box (in which is 5 Zm) here.

>x sign
You see nothing special about the sign spinner.

>x sketch
You see nothing special about Zheng Yi Sao's Sketch.

>x sign
You see nothing special about the sign spinner.

With a start, you recognize her from her portrait: it's Zheng Yi Sao, the infamous pirate queen who conquered China. For a moment, she stops spinning the sign and gets a steely look in her eyes. "You know who I am," she says coolly. "Then you must know what I'm capable of. If you want to stay on friendly terms, I recommend you keep this on the down-low."

>x sign
You see nothing special about the sign spinner.

>x sign
You see nothing special about the sign spinner.

With a start, you recognize her from her portrait: it's Zheng Yi Sao, the infamous pirate queen who conquered China. For a moment, she stops spinning the sign and gets a steely look in her eyes. "You know who I am," she says coolly. "Then you must know what I'm capable of. If you want to stay on friendly terms, I recommend you keep this on the down-low."

* * *

Welcome
An Interactive Fiction
Release 1 / Serial number 240407 / Inform 7 build 6M62 (I6/v6.34 lib 6/12N) SD

Lab
You can see 23 Zm, a desk and a box (in which is 5 Zm) here.

>x sketch
You see nothing special about Zheng Yi Sao's Sketch.

>showme sketch
Zheng Yi Sao's Sketch - thing
location: in the lab
singular-named, proper-named; unlit, inedible, portable
list grouping key: none
printed name: "Zheng Yi Sao's Sketch"
printed plural name: none
indefinite article: none
description: none
initial appearance: none

* * *

Welcome
An Interactive Fiction
Release 1 / Serial number 240407 / Inform 7 build 6M62 (I6/v6.34 lib 6/12N) SD

Lab
You can see 23 Zm, a desk and a box (in which is 5 Zm) here.

>y
That was a rhetorical question.

>q
Are you absolutely certain you want to quit?

* * *

Welcome
An Interactive Fiction
Release 1 / Serial number 240407 / Inform 7 build 6M62 (I6/v6.34 lib 6/12N) SD

Lab
You can see 23 Zm, a desk and a box (in which is 5 Zm) here.

>z
Time passes.

* * *

>jump
Turn count reset.

I beg your pardon?

>z
Time passes.

>take ball
Taken.

* * *

>z
Time passes.

>jump
Turn count reset

>z
Time passes.

foo

>jump
Turn count reset

>z
Time passes.

>z
Time passes.

"So close and yet so far."

>jump
foo

>z
Time passes.

* * *

>z
Time passes.

* * *

>z
Time passes.

"So close and yet so far."

>z
Time passes.

>z
Time passes.

Your stomach rumbles.

>z
Time passes.

>z
Time passes.

"This is taking forever."

>z
Time passes.

>z
Time passes.

*BEEP*

>z
Time passes.